000,102,000,000,102,000,000,
101,110,101,101,110,101,000,
000,102,000,000,102,000,000,
000,107,101,101,106,000,000,
000,000,000,000,000,000,000,
000,000,000,000,000,000,000,
000,000,000,000,000,000,000,