000,000,000,000,000,000,000,000,000,000,000,000,000,000,000,000,000,000,
000,000,000,000,000,000,000,105,101,101,108,000,000,000,000,000,000,000,
000,105,101,101,108,000,000,102,000,000,102,000,000,000,000,000,000,000,
000,102,000,000,102,000,000,102,000,000,102,000,000,000,000,000,000,000,
101,110,000,000,110,101,101,110,000,000,110,101,110,101,110,101,108,000,
000,102,000,000,102,000,000,102,000,000,102,000,102,000,102,000,102,000,
000,102,000,000,102,000,000,107,101,101,106,000,110,101,110,101,110,000,
000,107,101,101,106,000,000,000,000,000,000,000,102,000,102,000,102,000,
000,000,000,000,000,000,000,000,000,000,000,000,107,101,110,101,106,000,
000,000,000,000,000,000,000,000,000,000,000,000,000,000,000,000,000,000,
000,000,000,000,000,000,000,000,000,000,000,000,000,000,000,000,000,000,
000,000,000,000,000,000,000,000,000,000,000,000,000,000,000,000,000,000,
000,000,000,000,000,000,000,000,000,000,000,000,000,000,000,000,000,000,
000,000,000,000,000,000,000,000,000,000,000,000,000,000,000,000,000,000,
000,000,000,000,000,000,000,000,000,000,000,000,000,000,000,000,000,000,
000,000,000,000,000,000,000,000,000,000,000,000,000,000,000,000,000,000,
000,000,000,000,000,000,000,000,000,000,000,000,000,000,000,000,000,000,
000,000,000,000,000,000,000,000,000,000,000,000,000,000,000,000,000,000,